4444444444
4033333334
4343434334
4303444034
4343333334
4343443454
4306334634
4344304334
4333344394
4444444444